6 5 4
1 1 1 1 1 1 0 1 0 0 1 0 1 1 0 0 1 0 0 1 0 0 1 1 1 1 0 0 1 0
0 1 0 0 1 0 0 0 0 0 0 0 0 0 0 0 0 0 0 0 0 0 0 0 0 0 0 0 0 0
0 1 0 0 1 0 0 0 0 0 0 0 0 0 0 0 0 0 0 0 0 0 0 0 0 0 0 0 0 0
1 1 1 1 1 1 1 0 0 0 0 1 1 0 0 0 1 1 1 1 0 0 0 1 1 0 0 0 1 1
30 12 12 30 30 30 00 12 13 30 00 13 13 30 00 13 13 00 00 13
30 05 01 01 05 12 30 01 00 00 30 30 30 01 30 30 30 30 30 12 01 01 30 30
12 30 12 12 04 12 01 01 30 30 01 01 12 01 30 30 12 01 01 12 30 30 01 12 30 30 30 30 30 30