7 6 6
0 1 0 1 0 1 0 0 1 0 1 0 1 0 0 1 0 1 0 1 0 1 1 0 1 0 1 1 0 0 0 1 0 0 0 0 0 0 1 0 0 0
0 1 1 1 1 1 0 0 1 1 1 1 1 0 0 0 0 0 0 0 0 0 0 0 0 0 0 0 1 0 0 0 0 0 1 1 1 1 0 1 1 1
1 1 1 1 1 1 1 0 1 1 1 1 1 0 0 0 1 0 1 0 0 0 0 1 0 1 0 0 1 0 1 0 1 0 1 0 0 0 1 0 0 0
0 0 1 1 1 0 0 0 0 0 0 0 0 0 0 0 0 0 0 0 0 0 0 0 0 0 0 0 1 0 0 0 0 0 1 1 0 0 1 0 0 1
0 0 0 1 0 0 0 0 0 0 0 0 0 0 0 0 0 0 0 0 0 0 0 0 0 0 0 0 1 0 0 0 0 0 1 0 0 1 0 1 0 0
1 1 1 1 1 1 1 1 0 1 1 1 0 1 1 0 0 0 0 0 1 1 0 0 0 0 0 1 1 0 1 1 1 0 1 1 0 1 0 1 0 1
23 05 30 03 01 30 23 05 05 30 30 25 23 30 30 30 30 12 25 30 30 30 30 12 30 12 24 12 12 25 30 16 30 23 12 24
01 04 30 30 30 04 30 02 30 13 30 13 30 30 30 02 05 13 05 30 12 02 30 01 30 01 30 02 01 30 01 01 01 30 01 30 01 14 13 14 30 30
12 30 30 30 14 14 12 01 03 13 14 30 03 30 01 01 01 01 01 01 01 12 01 01 01 01 01 12 30 30 12 12 12 30 05 23 30 13 13 13 01 23