9 9 3
1 1 1 1 1 1 0 1 1 1 0 1 0 1 0 0 0 0 1 0 1 0 1 0 0 0 0 1 1 1 1 1 0 0 0 0 1 0 1 0 1 0 0 0 0 1 1 1 1 1 0 0 0 0 1 0 1 0 1 0 0 1 0 1 1 1 1 1 0 0 0 0 1 0 1 0 1 0 0 0 0
1 1 1 1 1 1 1 1 1 1 0 0 0 0 0 0 1 0 1 0 0 0 0 0 0 1 0 1 0 0 0 1 0 0 1 0 1 0 0 0 0 0 0 1 0 1 0 0 0 1 0 0 1 0 1 0 0 0 0 0 0 1 0 1 1 1 1 1 0 0 1 0 0 0 0 0 0 0 0 1 0
1 1 1 1 1 1 0 1 1 1 0 1 0 1 0 0 0 0 1 0 1 0 1 0 0 0 0 1 1 1 1 1 0 0 0 0 1 0 1 0 1 0 0 0 0 1 1 1 1 1 0 0 0 0 1 0 1 0 1 0 0 1 0 1 1 1 1 1 0 0 0 0 1 0 1 0 1 0 0 0 0
18 09 18 23 12 23 23 12 23 05 23 05 23 12 23 05 23 05 24 12 24 05 16 05 23 01 23
30 30 09 30 30 01 30 12 01 08 12 12 12 24 01 01 30 01 30 30 09 30 30 01 30 12 01
30 30 30 30 30 30 01 30 30 30 30 30 30 30 30 00 30 30 30 30 30 30 30 30 00 01 30 30 30 30 30 30 30 30 30 30 30 30 30 30 30 30 00 01 30 30 30 30 30 30 30 30 30 30 03 30 30 30 12 30 30 30 30 30 30 30 30 30 30 30 30 30 30 30 30 30 30 30 00 01 30