4 2 4
1 1 1 1 1 1 0 1
1 0 0 1 0 0 0 1
1 0 0 1 1 0 0 0
1 1 1 1 1 0 1 1
04 12 12 30 13 01 30 13
30 30 01 30 01 30 30 30 30 30 30 01 02 01 30 02
30 12 12 30 13 01 01 13