4 5 4
1 1 1 1 0 1 1 0 0 1 1 0 0 1 1 0 0 1 1 0
0 0 0 0 0 0 0 0 0 0 0 0 0 1 1 0 0 0 0 0
0 0 0 0 0 0 0 0 0 1 1 0 0 0 0 0 0 0 0 0
1 0 0 1 1 0 0 1 1 1 1 1 0 0 0 0 0 1 1 0
30 30 30 12 02 30 30 12 02 30 30 30 02 02 30 30 02 30 30 30
01 30 30 01 00 01 01 30 00 01 01 00 03 12 30 03
30 01 01 12 30 30 01 01 30 13 13 01 30 02 02 30 30 12 12 00