3 3 4
1 0 1 0 0 0 0 0 0
1 0 1 1 0 1 1 0 1
1 0 1 1 1 1 0 0 0
1 0 1 0 0 0 0 0 0
30 30 30 30 30 30 30 30 30 30 30 30
01 30 01 30 30 30 02 01 02 01 30 01
04 00 04 02 01 02 01 00 01