6 6 6
1 1 1 1 1 1 0 1 0 0 1 0 0 0 0 0 0 0 0 0 0 0 0 0 0 0 0 0 0 0 0 0 0 0 0 0
1 1 0 0 1 1 1 1 0 0 1 1 0 1 1 1 1 0 0 0 1 0 0 0 0 1 1 1 1 0 0 1 1 1 1 0
1 0 0 0 0 1 1 0 0 0 0 1 0 1 0 0 0 0 0 0 0 0 0 0 0 0 0 0 0 0 0 0 0 0 0 0
1 0 0 0 0 1 1 0 0 0 0 1 0 1 0 0 1 0 0 1 0 0 0 0 0 1 1 1 1 0 0 1 0 0 1 0
1 1 0 0 1 1 1 1 0 0 1 1 0 1 1 1 1 0 0 0 0 1 0 0 0 1 1 1 1 0 0 1 1 1 1 0
1 1 1 1 1 1 0 1 0 0 1 0 0 0 0 0 0 0 0 0 0 0 0 0 0 0 0 0 0 0 0 0 0 0 0 0
30 14 12 12 14 30 12 14 12 12 14 12 00 04 12 30 04 00 00 01 01 30 01 00 00 04 04 04 04 00 00 30 12 12 30 00
01 02 01 01 30 01 02 15 30 13 15 02 02 13 30 30 30 02 02 04 30 30 13 02 02 15 30 30 15 02 01 02 01 01 30 01
30 14 12 12 14 30 30 14 30 30 14 30 30 30 12 12 30 00 30 30 01 01 30 30 30 04 30 30 30 30 30 30 12 12 30 30