3 4 4
0 1 0 0 0 0 0 1 0 0 1 0
0 1 0 0 0 0 1 1 1 0 0 0
0 1 0 0 0 0 0 0 0 0 0 0
1 1 1 0 0 0 0 1 0 0 0 0
30 01 01 30 30 30 30 30 30 30 30 30 30 30 30 30
00 13 00 01 12 01 00 01 00 01 12 01
01 30 01 30 30 30 01 13 01 30 30 30