5 4 5
1 1 1 1 1 0 0 1 0 0 0 0 0 0 0 0 0 0 0 0
1 0 1 0 1 0 0 0 0 0 0 0 1 0 0 0 0 0 0 0
1 1 1 1 1 1 0 0 0 1 0 1 0 1 0 0 0 1 0 0
1 0 1 0 1 0 0 0 0 0 0 0 1 0 0 0 0 0 0 0
1 1 1 1 1 0 0 1 0 0 0 0 0 0 0 0 0 0 0 0
30 23 30 30 30 01 00 12 30 01 00 01 12 01 00 00 30 30 00 00
01 01 02 01 01 01 30 12 30 01 02 12 12 12 02 01 00 12 00 01 01 01 02 01 01
30 30 30 30 30 01 30 30 30 01 30 30 30 30 30 30 00 01 00 30