6 5 6
1 0 1 1 0 1 1 0 0 0 0 1 1 0 0 0 0 1 1 0 0 0 0 1 1 0 1 1 0 1
1 0 0 0 0 1 0 0 0 0 0 0 0 0 0 0 0 0 1 0 0 0 0 1 0 0 0 0 0 0
1 0 1 1 0 1 1 0 1 1 0 1 0 0 1 1 0 0 0 0 1 0 0 0 1 0 0 1 0 1
1 0 1 1 0 1 1 0 1 1 0 1 0 0 1 1 0 0 0 0 0 1 0 0 1 0 1 0 0 1
1 0 0 0 0 1 0 0 0 0 0 0 0 0 0 0 0 0 1 0 0 0 0 1 0 0 0 0 0 0
1 0 1 1 0 1 1 0 0 0 0 1 1 0 0 0 0 1 1 0 0 0 0 1 1 0 1 1 0 1
24 12 24 24 12 24 12 00 24 24 00 12 12 00 02 02 00 12 12 12 01 01 12 12 24 00 23 23 00 24
30 30 12 12 30 30 12 30 30 30 00 30 13 30 04 14 30 30 30 30 14 30 30 13 12 30 30 30 30 12 30 30 12 12 30 30
30 30 24 24 30 30 24 30 30 30 00 30 12 30 02 02 00 30 14 30 30 01 30 14 30 30 30 23 30 24