4 4 4
0 0 0 0 0 1 1 0 0 1 1 0 0 0 0 0
0 1 1 0 1 0 0 1 1 0 0 1 0 1 1 0
0 1 1 0 1 0 0 1 1 0 0 1 0 1 1 0
0 0 0 0 0 1 1 0 0 1 1 0 0 0 0 0
00 02 02 00 02 12 12 02 02 12 12 02 00 02 02 00
30 30 30 30 30 12 12 02 30 12 12 02 30 30 30 00
30 30 30 30 30 12 12 30 30 12 12 02 30 30 30 30